d,t,t,t,a
d,l,d,l,j
l,n,n,n,r
l,d,n,d,g
h,h,c,b,i
S(0,0)
E(4,4)
