d,t,t,t,t,t,t,t,t,t,t,t,j
l,d,t,t,t,t,t,t,t,t,t,t,g
l,t,t,t,d,t,t,l,d,t,t,l,r
l,l,l,n,l,t,d,n,l,l,n,d,a
l,t,d,l,n,t,n,l,n,l,l,n,g
l,n,l,l,n,d,t,l,d,t,d,t,j
l,l,n,l,d,l,n,l,l,l,l,l,g
l,t,l,l,n,l,n,l,l,l,l,l,g
d,t,n,t,d,l,n,l,l,l,l,l,g
l,l,n,l,l,l,n,l,l,l,l,l,g
l,d,t,n,n,l,n,l,l,l,l,l,g
l,l,l,n,l,l,n,l,l,l,l,l,g
k,b,k,c,b,h,b,h,b,h,b,h,f
S(0,12)
E(12,0)
