d,d,d,d,d,t,t,t,t,t,a
d,d,n,t,n,d,t,t,l,d,g
d,n,l,t,d,l,n,n,l,l,g
l,d,l,d,n,l,d,n,l,n,g
l,t,l,n,l,n,l,t,t,l,g
d,l,d,n,n,l,l,l,n,l,g
d,n,t,t,l,l,d,t,l,l,g
l,d,l,d,t,t,n,n,l,l,g
l,t,n,l,d,l,l,l,n,l,a
d,l,d,l,n,l,n,l,l,l,g
k,c,c,c,b,c,c,c,c,c,m
S(0,10)
E(10,10)
