d,t,t,d,t,t,t,d,t,d,t,t,j
d,n,l,l,d,t,d,n,l,n,d,l,g
l,d,l,n,l,l,l,t,t,l,l,t,r
l,l,l,t,n,l,t,t,n,l,l,l,r
l,l,d,t,d,t,t,t,t,l,n,d,g
l,l,n,l,l,d,t,t,l,d,t,n,g
l,d,t,l,n,l,l,l,l,n,l,l,g
l,l,l,n,l,l,t,n,l,l,l,d,r
l,d,n,n,l,n,n,n,n,l,d,n,g
l,l,d,d,t,t,t,t,t,l,l,t,g
l,n,l,n,n,l,t,l,n,n,t,l,a
d,t,n,t,l,t,l,t,t,t,n,l,g
k,c,h,b,h,b,b,b,k,c,h,k,f
S(6,6)
E(11,12)
