d,t,t,t,t,t,d,t,t,t,t,a
l,d,t,l,n,n,t,d,n,l,d,a
l,l,l,l,d,t,d,n,l,l,l,g
l,l,n,n,n,l,l,d,n,l,l,g
l,d,l,l,l,l,l,t,d,n,n,g
l,l,n,l,l,l,d,n,l,t,d,r
l,d,l,l,l,t,t,t,l,l,l,g
d,n,n,l,t,t,d,t,t,t,l,a
l,d,t,t,t,l,l,n,d,l,n,a
l,l,t,t,l,l,l,l,l,l,t,g
l,t,t,n,l,t,n,n,l,l,l,g
k,c,c,c,c,c,h,h,b,h,h,m
S(5,5)
E(6,5)
