d,t,t,d,t,t,t,d,t,t,a
d,t,n,n,n,d,t,l,d,t,r
l,d,t,l,d,t,n,n,t,d,g
l,n,l,n,d,t,t,d,t,n,r
l,t,d,t,n,t,l,n,t,t,g
d,n,l,t,d,t,t,t,t,l,g
l,t,t,n,l,t,t,t,l,t,g
l,d,t,n,l,t,l,l,l,d,a
l,d,t,t,t,t,n,l,t,n,g
l,l,l,l,l,l,l,l,d,n,j
h,c,b,h,h,c,h,h,c,c,f
S(3,10)
E(9,5)
