d,t,t,t,d,t,t,t,d,j
l,d,t,n,n,t,d,t,n,r
l,l,t,t,t,l,n,d,n,j
l,l,t,t,d,t,t,l,t,r
l,t,l,t,l,d,n,l,l,g
l,t,t,d,n,t,t,l,l,a
d,t,n,d,d,t,n,l,t,g
l,d,n,n,l,d,t,t,n,g
l,t,l,t,l,t,d,t,n,g
k,c,b,c,c,h,b,k,c,f
S(0,0)
E(5,4)
