d,d,d,t,t,d,d,d,t,t,d,t,a
l,n,l,d,t,n,l,l,d,t,l,t,a
l,l,l,l,n,l,l,l,l,l,l,d,r
l,l,n,n,t,t,l,l,n,l,l,d,a
l,l,d,d,l,n,l,n,l,l,l,n,r
l,l,n,l,d,n,l,l,n,l,t,t,g
l,l,l,l,l,t,l,l,l,t,l,n,r
l,l,l,l,n,l,l,l,t,l,t,l,a
l,l,l,d,n,d,n,l,l,d,t,l,r
l,d,n,l,t,d,t,n,d,n,t,t,r
l,l,d,l,t,l,t,d,l,d,n,t,a
l,l,n,t,l,d,t,l,l,l,l,d,g
l,d,t,l,l,l,l,l,t,n,l,l,g
k,b,h,b,h,b,h,c,c,c,c,c,f
S(12,0)
E(0,13)
