d,t,t,t,t,d,t,d,a
l,t,l,d,n,n,t,l,g
l,l,l,t,t,l,l,n,g
l,l,t,t,l,l,t,d,r
l,t,t,l,l,t,t,l,a
d,t,n,l,t,t,t,d,g
l,t,t,l,d,t,l,l,a
d,t,l,l,b,l,t,l,g
h,c,b,c,b,h,c,c,f
S(0,0)
E(7,7)
