d,t,t,t,t,d,d,t,t,t,t,t,t,t,j
l,d,t,n,t,n,t,t,l,t,t,t,t,l,g
l,t,t,t,t,t,n,n,d,t,t,t,l,l,r
l,d,t,t,t,t,t,t,n,t,l,l,l,d,a
l,l,d,t,t,t,t,l,n,l,l,l,l,l,a
l,l,l,d,t,t,l,l,n,l,l,l,l,t,g
l,l,n,l,d,l,l,l,n,n,n,l,t,l,r
l,d,t,n,l,l,l,t,t,d,l,l,d,n,j
l,l,d,t,l,n,t,t,l,l,l,l,l,d,r
l,n,l,t,n,d,t,t,l,l,l,l,l,l,j
d,t,t,t,n,l,d,l,n,l,l,l,l,l,a
l,l,l,t,n,l,l,t,t,n,l,t,n,d,g
l,l,t,t,t,n,l,d,t,n,d,t,l,l,g
l,t,t,t,d,t,n,l,d,n,l,l,l,n,g
h,c,c,c,b,k,c,b,h,c,b,c,c,c,f
S(0,14)
E(14,0)
