d,t,t,t,t,d,a
l,d,t,d,n,l,g
l,n,l,l,t,n,g
d,t,n,d,l,t,g
l,l,t,n,l,n,a
l,t,t,t,d,t,g
h,c,c,h,b,h,i
S(0,0)
E(6,6)
