d,t,t,t,t,d,t,d,a
l,t,l,d,n,n,t,l,g
l,l,l,t,t,l,l,n,g
l,l,t,t,l,l,t,d,r
l,t,t,l,l,t,t,d,a
d,t,n,l,t,t,t,l,g
l,t,t,n,t,t,t,l,g
d,t,l,l,n,l,d,n,g
h,c,b,c,b,h,c,c,f
S(0,0)
E(7,7)
