d,t,t,t,t,a
d,t,n,l,l,r
l,n,t,n,l,g
l,l,n,n,n,g
l,n,n,n,d,g
l,n,l,n,l,r
h,b,b,b,b,f
S(0,0)
E(5,7)
