d,t,t,t,t,d,t,t,t,t,a
d,d,n,t,l,l,d,t,t,d,a
l,l,t,d,n,l,n,t,l,l,g
l,l,l,l,l,t,t,t,n,n,g
l,l,l,t,t,t,l,d,t,t,g
l,n,l,l,l,l,l,l,t,d,r
l,l,t,t,t,n,l,l,l,l,a
l,t,t,d,d,t,n,l,l,t,g
l,d,n,n,d,t,t,n,l,n,r
d,t,t,t,t,l,d,t,d,t,j
h,c,c,c,h,b,b,h,b,h,f
S(10,0)
E(3,7)
