d,t,d,t,t,t,d,t,d,t,a
d,l,t,n,d,n,n,l,n,d,a
l,l,d,t,t,t,d,t,t,l,g
l,l,l,t,l,d,l,t,l,n,g
l,l,l,l,n,n,t,t,l,d,r
l,n,l,l,n,t,d,n,d,n,g
l,l,t,n,d,d,n,t,l,d,r
l,l,d,l,l,l,d,t,l,t,g
l,l,l,n,l,l,t,n,l,d,r
l,l,t,t,n,t,t,l,n,l,a
h,b,b,b,b,k,b,h,b,k,f
S(2,7)
E(7,3)
