d,d,t,t,t,t,t,t,t,j
l,t,t,t,d,t,d,t,n,g
l,l,d,t,l,l,l,t,t,r
l,l,l,l,l,l,l,t,t,g
d,l,n,l,l,l,l,d,n,g
l,n,d,n,l,l,t,t,t,r
l,d,l,l,t,l,l,t,t,g
l,l,t,t,l,l,l,d,n,g
l,l,t,l,l,d,t,t,t,r
h,c,c,b,h,b,h,c,c,m
S(9,0)
E(0,0)
