d,t,t,t,t,t,t,t,d,a
d,t,d,t,d,t,t,l,l,a
d,n,l,l,l,d,l,l,t,g
l,n,l,l,l,l,l,t,l,g
l,l,d,l,l,l,n,n,n,g
l,l,l,l,l,t,t,t,l,r
l,l,l,n,t,l,d,l,t,g
d,l,l,l,l,n,n,d,t,g
l,l,n,l,t,t,t,n,l,g
h,h,c,c,c,h,c,h,h,i
S(9,0)
E(9,9)
