d,t,t,t,t,t,t,t,t,t,a
l,l,t,t,t,t,t,t,d,l,g
d,n,d,t,d,t,t,t,n,l,r
l,l,l,l,l,d,t,l,l,l,j
l,l,l,l,l,l,l,l,l,n,g
l,t,l,l,l,d,l,l,d,t,g
d,l,l,l,l,n,l,l,l,l,g
l,l,l,l,t,t,n,d,l,l,g
l,l,l,t,t,t,t,l,l,l,g
l,l,n,t,t,t,t,n,l,l,g
h,c,h,c,c,c,c,b,b,h,f
S(5,4)
E(5,5)
